date,cases,deaths,hospitalized,ICU,recovered
2020-02-14,1,0,0,0,1
2020-02-19,2,0,0,0,2
2020-02-20,3,0,0,0,3
2020-03-23,5,0,1,0,4
2020-03-24,6,0,2,0,4
2020-03-26,7,0,3,0,4
2020-03-28,9,0,5,0,4
2020-03-30,10,0,6,0,4
2020-04-03,12,0,8,0,4
2020-04-04,17,0,13,0,4
2020-04-06,23,0,17,0,6
2020-04-07,34,0,27,0,7
2020-04-08,39,0,32,0,7
2020-04-09,42,0,35,0,7
2020-04-10,49,0,42,0,7
2020-04-11,57,0,50,0,7
2020-04-12,66,0,59,0,7
2020-04-13,73,0,66,0,7
